11111111
10000001
1PCCCE01
10000001
11111111