11111111111111111111111111111111111111
10000P1000C000C00010000000000000000001
1000111000C000000010000000000000000001
100000000C0C000000100000000C0000000001
1000C0000C0000000E00000000000000000001
1000000000000000000000100000C000000001
10000000000000000000001000000000000001
1000001000C000C00010001000000000000001
1000111000C00000001000100C000000000001
100000000C0C00000010001000000000000001
1000C0000C000000001CCC1000000C00000001
11111111111111111111111111111111111111