11111111111111111111111111111111111111111111
1E0000000000000C00000C000000000001000C000001
1010010100100000101001000000010101000C000001
1010010010101010001001000000010101000C000001
100000000C00C0000000000000000000C0000C000001
1010010100100000101001000000010101000C000001
1010010100100000101001000000010101000C000001
1010010100100000101001000000010101000C000001
1010010100100000101001000000010101000C000001
1010010100100000101001000000010101000C000001
1010010100100000101001000000010101000C000001
1010010100100000101001000000010101000C000001
1010010100100000101001000000010101000C000001
1010010100100000101001000000010101000C000001
1010010100100000101001000000010101000C000001
1010010100100000101001000000010101000C000001
1010010100100000101001000000010101000C000001
1010010100100000101001000000010101000C000P01
1010010100100000101001000000010101000C000001
1010010100100000101001000000010101000C000001
1010010100100000101001000000010101000C000001
1010010100100000101001000000010101000C000001
1010010100100000101001000000010101000C000001
1010010100100000101001000000010101000C000001
1010010100100000101001000000010101000C000001
1010010100100000101001000000010101000C000001
11111111111111111111111111111111111111111111