1111111111111111111
100000P100000000001
1011111000000000001
1000000000000000001
10E00000000C0000011
1111111111111111111