1111111111111111111
10000P1000C000C0001
1000111000C00000001
100000000C0C0000001
1000C0000C0000000E1
1111111111111111111