1111111111111111111
1CCC0P1000C00000001
1000111000C00000001
100000000C000000001
10E0C0000C000000011
1111111111111111111